2,0,0,6,0,1
0,1,1,1,1,1
0,1,0,1,6,1
0,1,0,1,1,1
0,1,0,1,1,1
4,0,0,1,1,3